statement	score	confidence	gemini_2_5_flash
4-Nitrobiphenyl	3	not classifiable	carcinogenic to humans
ortho-Dichlorobenzene	3	not classifiable	not classifiable
Coumarin	3	not classifiable	not classifiable
2,5-Diaminotoluene	3	not classifiable	not classifiable
5-Chloro-ortho-toluidine	3	not classifiable	possibly carcinogenic
2,5-Xylidine	3	not classifiable	not classifiable
Amaranth	3	not classifiable	not classifiable
Ethylenethiourea	3	not classifiable	possibly carcinogenic
4,4',6-Trimethylangelicin plus ultraviolet A radiation	3	not classifiable	probably carcinogenic
Disulfiram	3	not classifiable	not classifiable
Eugenol	3	not classifiable	not classifiable
3,3'-Dimethoxybenzidine-4,4'-diisocyanate	3	not classifiable	not classifiable
5-Methylangelicin plus ultraviolet A radiation	3	not classifiable	probably carcinogenic
gamma-Butyrolactone	3	not classifiable	possibly carcinogenic
Benzoyl peroxide	3	not classifiable	not classifiable
2,4-Xylidine	3	not classifiable	possibly carcinogenic
Furfural	3	not classifiable	not classifiable
Methyl bromide	3	not classifiable	not classifiable
Methyl chloride	3	not classifiable	not classifiable
Nitrotoluenes	3	not classifiable	possibly carcinogenic
5-Nitro-ortho-toluidine	3	not classifiable	possibly carcinogenic
Rhodamine 6G	3	not classifiable	not classifiable
tert-Amyl methyl ether	3	not classifiable	not classifiable
Opisthorchis viverrini (infection with)	1	carcinogenic to humans	carcinogenic to humans
1,2-Diamino-4-nitrobenzene	3	not classifiable	not classifiable
Ethylene	3	not classifiable	not classifiable
N-Methyl-N,4-dinitrosoaniline	3	not classifiable	not classifiable
2-Amino-4-nitrophenol	3	not classifiable	not classifiable
Helicobacter pylori (infection with)	1	carcinogenic to humans	carcinogenic to humans
5-Nitro-ortho-anisidine	3	not classifiable	possibly carcinogenic
Acheson process, occupational exposure associated with	1	carcinogenic to humans	carcinogenic to humans
Acid mists, strong inorganic	1	carcinogenic to humans	carcinogenic to humans
Methyl iodide	3	not classifiable	not classifiable
Schistosoma haematobium (infection with)	1	carcinogenic to humans	carcinogenic to humans
Metronidazole	2B	possibly carcinogenic	possibly carcinogenic
Methyleugenol	2A	probably carcinogenic	possibly carcinogenic
Areca nut	1	carcinogenic to humans	carcinogenic to humans
Aluminium production	1	carcinogenic to humans	carcinogenic to humans
β-Myrcene	2B	possibly carcinogenic	possibly carcinogenic
Alcoholic beverages	1	carcinogenic to humans	carcinogenic to humans
ortho-Anisidine (see also ortho-Anisidine hydrochloride)	2A	probably carcinogenic	possibly carcinogenic
ortho-Nitroanisole	2A	probably carcinogenic	possibly carcinogenic
1,4-Dioxane	2B	possibly carcinogenic	possibly carcinogenic
Auramine	2B	possibly carcinogenic	carcinogenic to humans
Bromoethane	3	not classifiable	possibly carcinogenic
N-Nitrosomethylvinylamine	2B	possibly carcinogenic	possibly carcinogenic
Methylarsonic acid	2B	possibly carcinogenic	probably carcinogenic
Phenobarbital	2B	possibly carcinogenic	possibly carcinogenic
Griseofulvin	2B	possibly carcinogenic	possibly carcinogenic
Engine exhaust, diesel	1	carcinogenic to humans	carcinogenic to humans
Primidone	2B	possibly carcinogenic	possibly carcinogenic
4-Chloro-ortho-toluidine	2A	probably carcinogenic	carcinogenic to humans
Auramine production	1	carcinogenic to humans	carcinogenic to humans
1,2,3-Trichloropropane	2A	probably carcinogenic	probably carcinogenic
Automotive gasoline (see also Gasoline engine exhaust, and Aviation gasoline)	1	carcinogenic to humans	possibly carcinogenic
Styrene-7,8-oxide	2A	probably carcinogenic	probably carcinogenic
Tetranitromethane	2B	possibly carcinogenic	not classifiable
Mitomycin C	2B	possibly carcinogenic	possibly carcinogenic
Benzidine, dyes metabolized to	1	carcinogenic to humans	carcinogenic to humans
alpha-Chlorinated toluenes (benzal chloride, benzotrichloride, benzyl chloride) and benzoyl chloride (combined exposures)	2A	probably carcinogenic	carcinogenic to humans
Nitrogen mustard N-oxide	2B	possibly carcinogenic	possibly carcinogenic
Indium tin oxide	2B	possibly carcinogenic	possibly carcinogenic
2,4,6-Tris(1-aziridinyl)-s-triazine	3	not classifiable	probably carcinogenic
Aloe vera, whole leaf extract	2B	possibly carcinogenic	possibly carcinogenic
Propylthiouracil	2B	possibly carcinogenic	possibly carcinogenic
N,N-Dimethylacetamide	2B	possibly carcinogenic	not classifiable
Betel quid with tobacco	1	carcinogenic to humans	carcinogenic to humans
Chloroprene	2B	possibly carcinogenic	not classifiable
Betel quid without tobacco	1	carcinogenic to humans	carcinogenic to humans
2-Methyl-1-nitroanthraquinone (uncertain purity)	2B	possibly carcinogenic	not classifiable
Coal, indoor emissions from household combustion of	1	carcinogenic to humans	carcinogenic to humans
Mercury and inorganic mercury compounds	3	not classifiable	not classifiable
Schistosoma japonicum (infection with)	2B	possibly carcinogenic	not classifiable
Arecoline	2B	possibly carcinogenic	possibly carcinogenic
1-Hydroxyanthraquinone	2B	possibly carcinogenic	not classifiable
Coal gasification	1	carcinogenic to humans	carcinogenic to humans
Amsacrine	2B	possibly carcinogenic	possibly carcinogenic
1-Chloro-2-methylpropene	2B	possibly carcinogenic	not classifiable
BK polyomavirus (BKV)	2B	possibly carcinogenic	not classifiable
Leucomalachite green (see also Malachite green)	2B	possibly carcinogenic	possibly carcinogenic
Bitumens, occupational exposure to hard bitumens and their emissions during mastic asphalt work	2B	possibly carcinogenic	possibly carcinogenic
Coke production	1	carcinogenic to humans	carcinogenic to humans
Merphalan	2B	possibly carcinogenic	carcinogenic to humans
N-[4-(5-Nitro-2-furyl)-2-thiazolyl]acetamide	2B	possibly carcinogenic	carcinogenic to humans
Molybdenum trioxide	2B	possibly carcinogenic	possibly carcinogenic
Cobalt(II) oxide	2B	possibly carcinogenic	possibly carcinogenic
Bracken fern	2B	possibly carcinogenic	possibly carcinogenic
Epstein-Barr virus	1	carcinogenic to humans	carcinogenic to humans
Chromium, metallic	3	not classifiable	not classifiable
Carrageenan, degraded (Poligeenan)	2B	possibly carcinogenic	possibly carcinogenic
Estrogen therapy, postmenopausal	1	carcinogenic to humans	carcinogenic to humans
Carpentry and joinery	2B	possibly carcinogenic	carcinogenic to humans
1,3-Dichloropropene (technical-grade)	2B	possibly carcinogenic	possibly carcinogenic
Vanadium pentoxide	2B	possibly carcinogenic	possibly carcinogenic
Isobutyl nitrite	2B	possibly carcinogenic	not classifiable
Sodium ortho-phenylphenate	2B	possibly carcinogenic	possibly carcinogenic
Gentian violet (see also Leucogentian violet)	2B	possibly carcinogenic	possibly carcinogenic
Estrogen-progestogen menopausal therapy (combined)	1	carcinogenic to humans	carcinogenic to humans
Estrogen-progestogen oral contraceptives (combined)	1	carcinogenic to humans	carcinogenic to humans
Chlorophenoxy herbicides	2B	possibly carcinogenic	not classifiable
1-[(5-Nitrofurfurylidene)amino]-2-imidazolidinone	2B	possibly carcinogenic	not classifiable
N-Nitrososarcosine	2B	possibly carcinogenic	probably carcinogenic
Firefighter (occupational exposure as a)	1	carcinogenic to humans	carcinogenic to humans
Fission products, including strontium-90	1	carcinogenic to humans	carcinogenic to humans
Diesel fuel, marine	2B	possibly carcinogenic	not classifiable
Carbon black	2B	possibly carcinogenic	possibly carcinogenic
Bromochloroacetic acid	2B	possibly carcinogenic	not classifiable
Chlorinated paraffins of average carbon chain length C12 and average degree of chlorination approximately 60%	2B	possibly carcinogenic	possibly carcinogenic
Dry cleaning (occupational exposures in)	2B	possibly carcinogenic	probably carcinogenic
Titanium dioxide	2B	possibly carcinogenic	possibly carcinogenic
Cupferron	2B	possibly carcinogenic	possibly carcinogenic
Aviation gasoline (see also Automotive gasoline, and Gasoline engine exhaust)	2B	possibly carcinogenic	not classifiable
Hepatitis B virus (chronic infection with)	1	carcinogenic to humans	carcinogenic to humans
Fluoro-edenite fibrous amphibole	1	carcinogenic to humans	carcinogenic to humans
Nitrilotriacetic acid and its salts	2B	possibly carcinogenic	possibly carcinogenic
Haematite mining (underground)	1	carcinogenic to humans	carcinogenic to humans
Sulfur dioxide	3	not classifiable	not classifiable
Fuel oils, residual (heavy)	2B	possibly carcinogenic	carcinogenic to humans
Engine exhaust, gasoline	2B	possibly carcinogenic	possibly carcinogenic
Phenazopyridine hydrochloride	2B	possibly carcinogenic	possibly carcinogenic
Goldenseal root powder	2B	possibly carcinogenic	possibly carcinogenic
Methylthiouracil	2B	possibly carcinogenic	possibly carcinogenic
Carbon tetrachloride	2B	possibly carcinogenic	possibly carcinogenic
4,4'-Thiodianiline	2B	possibly carcinogenic	possibly carcinogenic
Parathion	2B	possibly carcinogenic	possibly carcinogenic
Hepatitis C virus (chronic infection with)	1	carcinogenic to humans	carcinogenic to humans
Benz[a]anthracene	2B	possibly carcinogenic	probably carcinogenic
Hexachlorocyclohexanes	2B	possibly carcinogenic	not classifiable
Glycidyl stearate	3	not classifiable	not classifiable
Human T-cell lymphotropic virus type I	1	carcinogenic to humans	carcinogenic to humans
Hepatitis D virus (HDV)	1	carcinogenic to humans	carcinogenic to humans
Human immunodeficiency virus type 1 (infection with)	1	carcinogenic to humans	carcinogenic to humans
1,1-Dimethylhydrazine	2B	possibly carcinogenic	possibly carcinogenic
Ethyl acrylate	2B	possibly carcinogenic	possibly carcinogenic
Thiouracil	2B	possibly carcinogenic	not classifiable
Human cytomegalovirus (HCMV)	2B	possibly carcinogenic	not classifiable
Human immunodeficiency virus type 2 (infection with)	2B	possibly carcinogenic	carcinogenic to humans
Aramite®	2B	possibly carcinogenic	possibly carcinogenic
CI Basic Red 9	2B	possibly carcinogenic	carcinogenic to humans
Human papillomavirus (HPV) type 16	1	carcinogenic to humans	carcinogenic to humans
2,4-Hexadienal	2B	possibly carcinogenic	not classifiable
Human papillomavirus (HPV) types 26, 53, 66, 67, 70, 73, 82	2B	possibly carcinogenic	not classifiable
Human papillomavirus (HPV) type 18	1	carcinogenic to humans	carcinogenic to humans
Implanted foreign bodies of metallic cobalt, metallic nickel and an alloy powder containing 66-67% nickel, 13-16% chromium, and 7% iron	2B	possibly carcinogenic	carcinogenic to humans
Phenytoin	2B	possibly carcinogenic	carcinogenic to humans
3-Chloro-2-methylpropene, technical grade	2B	possibly carcinogenic	not classifiable
Human papillomavirus (HPV) types 30, 34, 69, 85, 97	2B	possibly carcinogenic	not classifiable
Human papillomavirus (HPV) type 33	1	carcinogenic to humans	carcinogenic to humans
beta-Propiolactone	2B	possibly carcinogenic	probably carcinogenic
Human papillomavirus (HPV) types 5 and 8 (in patients with epidermodysplasia verruciformis)	2B	possibly carcinogenic	carcinogenic to humans
Aziridine	2B	possibly carcinogenic	possibly carcinogenic
Chlordecone (Kepone)	2B	possibly carcinogenic	possibly carcinogenic
Cycasin	2B	possibly carcinogenic	probably carcinogenic
1-tert-Butoxypropan-2-ol	2B	possibly carcinogenic	not classifiable
Chlordane	2B	possibly carcinogenic	possibly carcinogenic
Human papillomavirus (HPV) types 31, 35, 39, 45, 51, 52, 56, 58, 59	1	carcinogenic to humans	carcinogenic to humans
Ionizing radiation (all types)	1	carcinogenic to humans	carcinogenic to humans
Iron and steel founding (occupational exposure during)	1	carcinogenic to humans	carcinogenic to humans
4-Nitropyrene	2B	possibly carcinogenic	possibly carcinogenic
Trimethylolpropane triacrylate, technical grade	2B	possibly carcinogenic	possibly carcinogenic
JC polyomavirus (JCV)	2B	possibly carcinogenic	possibly carcinogenic
Magnetic fields, extremely low-frequency	2B	possibly carcinogenic	possibly carcinogenic
Fast Green FCF	3	not classifiable	not classifiable
1,2-Diethylhydrazine	2B	possibly carcinogenic	possibly carcinogenic
Isoprene	2B	possibly carcinogenic	possibly carcinogenic
Pentachlorophenol (see also Polychlorophenols)	1	carcinogenic to humans	possibly carcinogenic
Orthopaedic implants of complex composition and cardiac pacemakers	3	not classifiable	not classifiable
N-Nitrosomorpholine	2B	possibly carcinogenic	probably carcinogenic
Aziridyl benzoquinone	3	not classifiable	not classifiable
Isonicotinic acid hydrazide (Isoniazid)	3	not classifiable	possibly carcinogenic
Cobalt(II) sulfide	3	not classifiable	not classifiable
Bromoform	3	not classifiable	possibly carcinogenic
Haematite	3	not classifiable	not classifiable
Rugulosin	3	not classifiable	not classifiable
1,1,2,2-Tetrachloroethane	2B	possibly carcinogenic	not classifiable
meta-Dichlorobenzene	3	not classifiable	not classifiable
Terpene polychlorinates (Strobane®)	3	not classifiable	not classifiable
4-Aminobiphenyl	1	carcinogenic to humans	carcinogenic to humans
2-Naphthylamine	1	carcinogenic to humans	carcinogenic to humans
Potassium bis(2-hydroxyethyl)dithiocarbamate	3	not classifiable	not classifiable
Dichloroacetic acid	2B	possibly carcinogenic	possibly carcinogenic
Other cobalt(II) compounds (not including Soluble cobalt(II) salts, Cobalt(II) oxide, Cobalt(II,III) oxide, and Cobalt(II) sulfide)	3	not classifiable	possibly carcinogenic
Benzidine	1	carcinogenic to humans	carcinogenic to humans
Paint manufacture (occupational exposure in)	3	not classifiable	carcinogenic to humans
2-Nitropropane	2B	possibly carcinogenic	possibly carcinogenic
Crude oil	3	not classifiable	not classifiable
Dibenzothiophene	3	not classifiable	not classifiable
Glycidyl oleate	3	not classifiable	possibly carcinogenic
Malonaldehyde	3	not classifiable	probably carcinogenic
Zeolites other than erionite (clinoptilolite, phillipsite,mordenite, non-fibrous Japanese zeolite, synthetic zeolites)	3	not classifiable	not classifiable
Benzo[a]fluorene	3	not classifiable	not classifiable
ortho-Toluidine	1	carcinogenic to humans	carcinogenic to humans
Pentavalent antimony	3	not classifiable	not classifiable
Rifampicin	3	not classifiable	not classifiable
Acriflavinium chloride	3	not classifiable	not classifiable
Chloroethane	3	not classifiable	not classifiable
Panfuran S (containing dihydroxymethylfuratrizine)	2B	possibly carcinogenic	carcinogenic to humans
Petroleum solvents	3	not classifiable	not classifiable
Bis(2,3-epoxycyclopentyl)ether	3	not classifiable	not classifiable
Androgenic (anabolic) steroids	2A	probably carcinogenic	carcinogenic to humans
Toxaphene (Polychlorinated camphenes)	2B	possibly carcinogenic	possibly carcinogenic
Benzo[b]naphtho[2,1-d]thiophene	3	not classifiable	not classifiable
Nitrovin	3	not classifiable	not classifiable
Trichloroacetonitrile	3	not classifiable	not classifiable
Captan	3	not classifiable	not classifiable
Polychlorinated dibenzo-para-dioxins (other than 2,3,7,8-tetrachlorodibenzo-para-dioxin)	3	not classifiable	not classifiable
Tris(1-aziridinyl)phosphine oxide	3	not classifiable	possibly carcinogenic
Saccharated iron oxide	3	not classifiable	not classifiable
Art glass, glass containers and pressed ware (manufacture of)	2A	probably carcinogenic	carcinogenic to humans
Bitumens, occupational exposure to straight-run bitumens and their emissions during road paving	2B	possibly carcinogenic	possibly carcinogenic
Vinylidene fluoride	3	not classifiable	not classifiable
Xylenes	3	not classifiable	not classifiable
Ethyl selenac	3	not classifiable	not classifiable
Biomass fuel (primarily wood), indoor emissions from household combustion of	2A	probably carcinogenic	carcinogenic to humans
1-Amino-2,4-dibromoanthraquinone	2B	possibly carcinogenic	not classifiable
Saccharin and its salts	3	not classifiable	not classifiable
Printing inks	3	not classifiable	not classifiable
CI Pigment Red 3	3	not classifiable	not classifiable
Benzo[b]fluorene	3	not classifiable	not classifiable
Iron sorbitol-citric acid complex	3	not classifiable	not classifiable
Polychlorinated dibenzofurans (see 2,3,4,7,8-Pentachlorodibenzofuran)	3	not classifiable	not classifiable
Proflavine salts	3	not classifiable	not classifiable
Carbon electrode manufacture	2A	probably carcinogenic	carcinogenic to humans
Mannomustine dihydrochloride	3	not classifiable	carcinogenic to humans
Musk xylene	3	not classifiable	not classifiable
Trichlormethine (Trimustine hydrochloride)	2B	possibly carcinogenic	carcinogenic to humans
1-Naphthylamine	3	not classifiable	carcinogenic to humans
Rhodamine B	3	not classifiable	not classifiable
N-Nitrosoguvacine	3	not classifiable	not classifiable
1,2-Bis(chloromethoxy)ethane	3	not classifiable	carcinogenic to humans
11-Aminoundecanoic acid	3	not classifiable	not classifiable
Frying, emissions from high-temperature	2A	probably carcinogenic	probably carcinogenic
4-Methylimidazole	2B	possibly carcinogenic	possibly carcinogenic
Pulp and paper manufacture	3	not classifiable	carcinogenic to humans
1-Amino-2-methylanthraquinone	3	not classifiable	possibly carcinogenic
Hairdresser or barber (occupational exposure as a)	2A	probably carcinogenic	probably carcinogenic
4,4'-Methylene bis(2-methylaniline)	2B	possibly carcinogenic	carcinogenic to humans
N-Phenyl-2-naphthylamine	3	not classifiable	possibly carcinogenic
cis-9,10-Epoxystearic acid	3	not classifiable	not classifiable
N-Nitrosoguvacoline	3	not classifiable	not classifiable
Rock (stone) wool	3	not classifiable	not classifiable
para-Aramid fibrils	3	not classifiable	not classifiable
Anthraquinone	2B	possibly carcinogenic	possibly carcinogenic
Chlorodifluoromethane	3	not classifiable	not classifiable
Cantharidin	3	not classifiable	not classifiable
SV40 polyomavirus	3	not classifiable	possibly carcinogenic
Quintozene (Pentachloronitrobenzene)	3	not classifiable	not classifiable
Doxylamine succinate	3	not classifiable	not classifiable
Human papillomavirus (HPV) type 68	2A	probably carcinogenic	not classifiable
Vinyl toluene	3	not classifiable	not classifiable
Silicone breast implants	3	not classifiable	not classifiable
Thiram	3	not classifiable	not classifiable
2,4,5-Trimethylaniline	3	not classifiable	not classifiable
Lead compounds, inorganic	2A	probably carcinogenic	probably carcinogenic
Carbazole	2B	possibly carcinogenic	not classifiable
Droloxifene	3	not classifiable	not classifiable
Nylon 6	3	not classifiable	not classifiable
Semicarbazide hydrochloride	3	not classifiable	not classifiable
Dimethoxane	3	not classifiable	not classifiable
Malaria (caused by infection with Plasmodium falciparum in holoendemic areas)	2A	probably carcinogenic	not classifiable
Acepyrene (3,4-dihydrocyclopenta[cd]pyrene)	3	not classifiable	not classifiable
Slag wool	3	not classifiable	possibly carcinogenic
Ziram	3	not classifiable	not classifiable
Dimethyl hydrogen phosphite	2B	possibly carcinogenic	not classifiable
2,6-Dimethylaniline (2,6-Xylidine)	2B	possibly carcinogenic	not classifiable
1,4-Bis(chloromethoxymethyl)benzene	3	not classifiable	carcinogenic to humans
Shikimic acid	3	not classifiable	not classifiable
Sulfites	3	not classifiable	PARSE_FAIL
Night shift work	2A	probably carcinogenic	probably carcinogenic
Acenaphthene	3	not classifiable	not classifiable
Gemfibrozil	3	not classifiable	not classifiable
Malachite green (see also Leucomalachite green)	3	not classifiable	possibly carcinogenic
Diacetylaminoazotoluene	3	not classifiable	possibly carcinogenic
Nitrate or nitrite (ingested) under conditions that result in endogenous nitrosation	2A	probably carcinogenic	probably carcinogenic
tert-Butyl alcohol	3	not classifiable	not classifiable
Dibenzo-para-dioxin	3	not classifiable	PARSE_FAIL
Allyl isothiocyanate	3	not classifiable	not classifiable
Non-arsenical insecticides (occupational exposures in spraying and application of)	2A	probably carcinogenic	probably carcinogenic
Cyclamates (sodium cyclamate)	3	not classifiable	not classifiable
Tea	3	not classifiable	not classifiable
Musk ambrette	3	not classifiable	not classifiable
2,4,6-Trichlorophenol (see also Polychlorophenols)	2B	possibly carcinogenic	possibly carcinogenic
Nithiazide	3	not classifiable	not classifiable
Ripazepam	3	not classifiable	not classifiable
2-Chloronitrobenzene	2B	possibly carcinogenic	not classifiable
Petroleum refining (occupational exposures in)	2A	probably carcinogenic	carcinogenic to humans
Tris(2-methyl-1-aziridinyl)phosphine oxide	3	not classifiable	possibly carcinogenic
Theobromine	3	not classifiable	not classifiable
Tetrakis(hydroxymethyl)phosphonium salts	3	not classifiable	not classifiable
Red meat (consumption of)	2A	probably carcinogenic	probably carcinogenic
1,4-Dichloro-2-nitrobenzene	2B	possibly carcinogenic	not classifiable
1-Methylphenanthrene	3	not classifiable	not classifiable
Wollastonite	3	not classifiable	not classifiable
Parasorbic acid	3	not classifiable	not classifiable
Chloropropham	3	not classifiable	not classifiable
Sulfamethazine	3	not classifiable	not classifiable
Pulegone	2B	possibly carcinogenic	possibly carcinogenic
Hydroxysenkirkine	3	not classifiable	not classifiable
Benzyl acetate	3	not classifiable	not classifiable
Agaritine	3	not classifiable	not classifiable
Cholesterol	3	not classifiable	not classifiable
Bromochloroacetonitrile	3	not classifiable	probably carcinogenic
para-Dimethylaminoazobenzenediazo sodium sulfonate	3	not classifiable	not classifiable
Dinitrosopentamethylenetetramine	3	not classifiable	not classifiable
Soluble cobalt(II) salts	2A	probably carcinogenic	possibly carcinogenic
Sunset Yellow FCF	3	not classifiable	not classifiable
Michler’s ketone [4,4´-Bis(dimethylamino)­benzophenone]	2B	possibly carcinogenic	possibly carcinogenic
Caffeine	3	not classifiable	not classifiable
Sudan I	3	not classifiable	possibly carcinogenic
Trivalent antimony	2A	probably carcinogenic	possibly carcinogenic
Kava extract	2B	possibly carcinogenic	not classifiable
Disperse Yellow 3	3	not classifiable	not classifiable
Tannic acid and tannins	3	not classifiable	not classifiable
2-Chloro-1,1,1-trifluoroethane	3	not classifiable	not classifiable
Pyrimethamine	3	not classifiable	not classifiable
Temazepam	3	not classifiable	not classifiable
4,4'-Methylenediphenyl diisocyanate	3	not classifiable	not classifiable
Very hot beverages at above 65 °C (drinking)	2A	probably carcinogenic	probably carcinogenic
Iron-dextran complex	2B	possibly carcinogenic	possibly carcinogenic
Phenanthrene	3	not classifiable	not classifiable
Theophylline	3	not classifiable	not classifiable
meta-Cresidine	3	not classifiable	possibly carcinogenic
n-Butyl acrylate	3	not classifiable	not classifiable
Styrene	2A	probably carcinogenic	possibly carcinogenic
Allyl isovalerate	3	not classifiable	not classifiable
Ginkgo biloba extract	2B	possibly carcinogenic	possibly carcinogenic
Triethanolamine	3	not classifiable	not classifiable
2-Nitronaphthalene	3	not classifiable	not classifiable
HC Red No. 3	3	not classifiable	not classifiable
Epichlorohydrin	2A	probably carcinogenic	probably carcinogenic
3,4-Epoxy-6-methylcyclohexylmethyl-3,4-epoxy-6-methylcyclo-hexanecarboxylate	3	not classifiable	not classifiable
Butyl benzyl phthalate	3	not classifiable	not classifiable
Naphthalene	2B	possibly carcinogenic	possibly carcinogenic
Methotrexate	3	not classifiable	not classifiable
Scarlet Red	3	not classifiable	not classifiable
Quinoline	2B	possibly carcinogenic	possibly carcinogenic
Phenicarbazide	3	not classifiable	not classifiable
Prednimustine	3	not classifiable	carcinogenic to humans
Vinblastine sulfate	3	not classifiable	not classifiable
Glycidyl methacrylate	2A	probably carcinogenic	not classifiable
Di(2-ethylhexyl) adipate	3	not classifiable	not classifiable
Methyl selenac	3	not classifiable	not classifiable
Yellow AB	3	not classifiable	not classifiable
Nitrofural (Nitrofurazone)	3	not classifiable	not classifiable
Ethylene dibromide	2A	probably carcinogenic	probably carcinogenic
N-Nitrosofolic acid	3	not classifiable	PARSE_FAIL
Prazepam	3	not classifiable	not classifiable
Paracetamol (Acetaminophen)	3	not classifiable	not classifiable
Acrolein	2A	probably carcinogenic	probably carcinogenic
Ferbam	3	not classifiable	not classifiable
N-Nitrosodi-n-butylamine	2B	possibly carcinogenic	probably carcinogenic
3,3'-Dichlorobenzidine	2B	possibly carcinogenic	possibly carcinogenic
Azobenzene	3	not classifiable	not classifiable
Aciclovir	3	not classifiable	not classifiable
Sudan III	3	not classifiable	not classifiable
N-Nitrosoproline	3	not classifiable	not classifiable
Sodium diethyldithiocarbamate	3	not classifiable	not classifiable
Methyl parathion	3	not classifiable	not classifiable
Chlorofluoromethane	3	not classifiable	not classifiable
N-Methylolacrylamide	2B	possibly carcinogenic	not classifiable
8-Hydroxyquinoline	3	not classifiable	not classifiable
Estazolam	3	not classifiable	not classifiable
Pioglitazone	2A	probably carcinogenic	possibly carcinogenic
Copper 8-hydroxyquinoline	3	not classifiable	not classifiable
Glyphosate	2A	probably carcinogenic	probably carcinogenic
3-(N-Nitrosomethylamino)propionaldehyde	3	not classifiable	not classifiable
Patulin	3	not classifiable	not classifiable
para-Anisidine	3	not classifiable	not classifiable
Methyl carbamate	3	not classifiable	not classifiable
N-Nitrosopyrrolidine	2B	possibly carcinogenic	possibly carcinogenic
Dichloroacetonitrile	3	not classifiable	probably carcinogenic
Pyrido[3,4-c]psoralen	3	not classifiable	not classifiable
HC Yellow No. 4	3	not classifiable	not classifiable
1,3-Propane sultone	2A	probably carcinogenic	possibly carcinogenic
7-Methylpyrido[3,4-c]psoralen	3	not classifiable	not classifiable
Dihydrosafrole	2B	possibly carcinogenic	not classifiable
para-Aminobenzoic acid	3	not classifiable	not classifiable
Safrole	2B	possibly carcinogenic	possibly carcinogenic
d-Limonene	3	not classifiable	not classifiable
N-Nitrosohydroxyproline	3	not classifiable	not classifiable
N,N'-Diethylthiourea	3	not classifiable	not classifiable
Methimazole	3	not classifiable	not classifiable
para-Benzoquinone dioxime	3	not classifiable	not classifiable
Tetrafluoroethylene	2A	probably carcinogenic	not classifiable
N-Nitrosodiphenylamine	3	not classifiable	not classifiable
Hydralazine	3	not classifiable	possibly carcinogenic
Monuron	3	not classifiable	not classifiable
Carbon nanotubes, multiwalled, other than MWCNT-7	3	not classifiable	possibly carcinogenic
Isopropyl alcohol manufacture using strong acids	1	carcinogenic to humans	carcinogenic to humans
Dichloroacetylene	3	not classifiable	not classifiable
MOPP and other combined chemotherapy including alkylating agents	1	carcinogenic to humans	carcinogenic to humans
Leather dust	1	carcinogenic to humans	carcinogenic to humans
Pentachloroethane	3	not classifiable	not classifiable
Kaposi sarcoma herpesvirus	1	carcinogenic to humans	carcinogenic to humans
Nickel compounds	1	carcinogenic to humans	carcinogenic to humans
Neutron radiation	1	carcinogenic to humans	carcinogenic to humans
Mineral oils, untreated or mildly treated	1	carcinogenic to humans	carcinogenic to humans
Magenta production	1	carcinogenic to humans	carcinogenic to humans
Silica, amorphous	3	not classifiable	not classifiable
Merkel cell polyomavirus (MCPyV)	1	carcinogenic to humans	carcinogenic to humans
Outdoor air pollution, particulate matter in	1	carcinogenic to humans	carcinogenic to humans
Opium consumption	1	carcinogenic to humans	carcinogenic to humans
Outdoor air pollution	1	carcinogenic to humans	carcinogenic to humans
Hydrochloric acid	3	not classifiable	not classifiable
Processed meat (consumption of)	1	carcinogenic to humans	carcinogenic to humans
Painter (occupational exposure as a)	1	carcinogenic to humans	carcinogenic to humans
Phenacetin, analgesic mixtures containing	1	carcinogenic to humans	carcinogenic to humans
Hydrogen peroxide	3	not classifiable	not classifiable
Radionuclides, alpha-particle-emitting, internally deposited	1	carcinogenic to humans	carcinogenic to humans
Rubber manufacturing industry	1	carcinogenic to humans	carcinogenic to humans
Solar radiation (see Ultraviolet radiation (wavelengths 100–400 nm, encompassing UVA, UVB, and UVC); Ultraviolet radiation from welding; and Ultraviolet-emitting tanning devices)	1	carcinogenic to humans	carcinogenic to humans
Radionuclides, beta-particle-emitting, internally deposited	1	carcinogenic to humans	carcinogenic to humans
Salted fish, Chinese-style	1	carcinogenic to humans	carcinogenic to humans
Soot (as found in occupational exposure of chimney sweeps)	1	carcinogenic to humans	carcinogenic to humans
Radioiodines, including iodine-131	1	carcinogenic to humans	carcinogenic to humans
Polychlorinated biphenyls, dioxin-like, with a Toxicity Equivalency Factor (TEF) according to WHO (PCBs 77, 81, 105, 114, 118, 123, 126, 156, 157, 167, 169, 189)	1	carcinogenic to humans	carcinogenic to humans
Tobacco smoking	1	carcinogenic to humans	carcinogenic to humans
Tobacco smoke, secondhand	1	carcinogenic to humans	carcinogenic to humans
Sodium chlorite	3	not classifiable	not classifiable
Tobacco, smokeless	1	carcinogenic to humans	carcinogenic to humans
Ultraviolet-emitting tanning devices (see Ultraviolet radiation (wavelengths 100–400 nm, encompassing UVA, UVB, and UVC); Ultraviolet radiation from welding; and Solar radiation)	1	carcinogenic to humans	carcinogenic to humans
Selenium and selenium compounds	3	not classifiable	not classifiable
2,4-D (2,4-dichlorophenoxyacetic acid) (See also Chlorophenoxy herbicides)	2B	possibly carcinogenic	possibly carcinogenic
Methyl tert-butyl ether	2B	possibly carcinogenic	possibly carcinogenic
Methylazoxymethanol acetate	2B	possibly carcinogenic	possibly carcinogenic
Welding fumes	1	carcinogenic to humans	carcinogenic to humans
Wood dust	1	carcinogenic to humans	carcinogenic to humans
Ultraviolet radiation from welding (see Ultraviolet radiation (wavelengths 100–400 nm, encompassing UVA, UVB, and UVC); Ultraviolet-emitting tanning devices; and Solar radiation)	1	carcinogenic to humans	carcinogenic to humans
Malathion	2A	probably carcinogenic	probably carcinogenic
Ultraviolet radiation (wavelengths 100–400 nm, encompassing UVA, UVB, and UVC) (see Ultraviolet radiation from welding; Ultraviolet-emitting tanning devices; and Solar radiation)	1	carcinogenic to humans	carcinogenic to humans
Carbon nanotubes, single-walled	3	not classifiable	probably carcinogenic
Metallic implants prepared as thin smooth films	2B	possibly carcinogenic	not classifiable
Dulcin	3	not classifiable	not classifiable
Tris(2,3-dibromopropyl) phosphate	2A	probably carcinogenic	probably carcinogenic
Methylmercury compounds	2B	possibly carcinogenic	possibly carcinogenic
Benzyl violet 4B	2B	possibly carcinogenic	not classifiable
Sulfallate	2B	possibly carcinogenic	not classifiable
Sulfasalazine	2B	possibly carcinogenic	not classifiable
Sudan II	3	not classifiable	not classifiable
Methylglyoxal	3	not classifiable	not classifiable
Eosin	3	not classifiable	not classifiable
Polychlorophenols and their sodium salts (mixed exposures) (see Pentachlorophenol; 2,4,6-Trichlorophenol)	2B	possibly carcinogenic	not classifiable
Tetrachloroethylene (Perchloroethylene)	2A	probably carcinogenic	probably carcinogenic
Pickled vegetables (traditional Asian)	2B	possibly carcinogenic	carcinogenic to humans
para-Aminoazobenzene	2B	possibly carcinogenic	possibly carcinogenic
ortho-Phenylenediamine	2B	possibly carcinogenic	not classifiable
3-Nitrobenzanthrone	2B	possibly carcinogenic	probably carcinogenic
Sepiolite	3	not classifiable	not classifiable
Evans blue	3	not classifiable	not classifiable
1-(2-Chloroethyl)-3-cyclohexyl-1-nitrosourea (CCNU) (Lomustine)	2A	probably carcinogenic	carcinogenic to humans
Perfluorooctanesulfonic acid (PFOS)	2B	possibly carcinogenic	carcinogenic to humans
para-Dimethylaminoazobenzene	2B	possibly carcinogenic	carcinogenic to humans
Isatidine	3	not classifiable	possibly carcinogenic
2,4-Diaminotoluene	2B	possibly carcinogenic	possibly carcinogenic
Streptozotocin	2B	possibly carcinogenic	possibly carcinogenic
Zectran	3	not classifiable	PARSE_FAIL
Acetamide	2B	possibly carcinogenic	possibly carcinogenic
ortho-Anisidine hydrochloride (see also ortho-Anisidine)	2A	probably carcinogenic	possibly carcinogenic
4-Chloro-ortho-phenylenediamine	2B	possibly carcinogenic	possibly carcinogenic
Polymeric implant prepared as thin smooth films (with the exception of poly-glycolic acid)	2B	possibly carcinogenic	possibly carcinogenic
Printing processes (occupational exposures in)	2B	possibly carcinogenic	carcinogenic to humans
1,5-Naphthalene diisocyanate	3	not classifiable	not classifiable
Nitrofen (technical-grade)	2B	possibly carcinogenic	possibly carcinogenic
3,3′,4,4′-Tetrachloroazobenzene	2A	probably carcinogenic	not classifiable
para-Nitrosodiphenylamine	3	not classifiable	not classifiable
3-(N-Nitrosomethylamino)propionitrile	2B	possibly carcinogenic	possibly carcinogenic
2-Amino-4-chlorophenol	2B	possibly carcinogenic	not classifiable
Phenelzine sulfate	3	not classifiable	possibly carcinogenic
HC Blue No. 2	3	not classifiable	not classifiable
Aniline hydrochloride (see also Aniline)	2A	probably carcinogenic	not classifiable
Dibenzo[a,h]pyrene	2B	possibly carcinogenic	carcinogenic to humans
Progestins (see also Progestogen-only contraceptives)	2B	possibly carcinogenic	probably carcinogenic
1,2-Dibromo-3-chloropropane	2B	possibly carcinogenic	carcinogenic to humans
2,2',5,5'-Tetrachlorobenzidine	3	not classifiable	not classifiable
5-Nitroacenaphthene	2B	possibly carcinogenic	carcinogenic to humans
Dibenzo[a,i]pyrene	2B	possibly carcinogenic	carcinogenic to humans
Diazomethane	3	not classifiable	not classifiable
2-Nitropyrene	3	not classifiable	possibly carcinogenic
Progestogen-only contraceptives	2B	possibly carcinogenic	possibly carcinogenic
Oxazepam	2B	possibly carcinogenic	possibly carcinogenic
Talc	2A	probably carcinogenic	not classifiable
Trifluralin	3	not classifiable	possibly carcinogenic
2,3-Dibromopropan-1-ol	2B	possibly carcinogenic	not classifiable
1-Methylchrysene	3	not classifiable	probably carcinogenic
2-Mercaptobenzothiazole	2A	probably carcinogenic	not classifiable
Bischloroethyl nitrosourea (BCNU) (Carmustine)	2A	probably carcinogenic	carcinogenic to humans
Gyromitrin	3	not classifiable	possibly carcinogenic
Indeno[1,2,3-cd]pyrene	2B	possibly carcinogenic	probably carcinogenic
Refractory ceramic fibres	2B	possibly carcinogenic	possibly carcinogenic
Radiofrequency electromagnetic fields	2B	possibly carcinogenic	possibly carcinogenic
Chlorothalonil	2B	possibly carcinogenic	possibly carcinogenic
4-Methylchrysene	3	not classifiable	possibly carcinogenic
Cisplatin	2A	probably carcinogenic	carcinogenic to humans
1,3-Dichloro-2-propanol	2B	possibly carcinogenic	possibly carcinogenic
2,6-Dinitrotoluene	2B	possibly carcinogenic	possibly carcinogenic
Chromium (III) compounds	3	not classifiable	not classifiable
3-Methylchrysene	3	not classifiable	possibly carcinogenic
2-Nitrofluorene	2B	possibly carcinogenic	possibly carcinogenic
3-Monochloro-1,2-propanediol	2B	possibly carcinogenic	possibly carcinogenic
Special-purpose fibres such as E-glass and '475' glass fibres	2B	possibly carcinogenic	not classifiable
2-Methylchrysene	3	not classifiable	possibly carcinogenic
7H-Dibenzo[c,g]carbazole	2B	possibly carcinogenic	carcinogenic to humans
Dibenzo[a,l]pyrene	2A	probably carcinogenic	carcinogenic to humans
Niridazole	2B	possibly carcinogenic	possibly carcinogenic
Methyl acrylate	2B	possibly carcinogenic	not classifiable
Isoeugenol	2B	possibly carcinogenic	not classifiable
4-Hydroxyazobenzene	3	not classifiable	not classifiable
Benzo[c]phenanthrene	2B	possibly carcinogenic	carcinogenic to humans
2,4-Dichloro-1-nitrobenzene	2B	possibly carcinogenic	not classifiable
Bisphenol A diglycidyl ether (Araldite)	3	not classifiable	not classifiable
Textile manufacturing industry (work in)	2B	possibly carcinogenic	carcinogenic to humans
2-Methylfluoranthene	3	not classifiable	not classifiable
Indium phosphide	2A	probably carcinogenic	probably carcinogenic
Weapons-grade tungsten (with nickel and cobalt) alloy	2B	possibly carcinogenic	not classifiable
1,1,2-Trichloroethane	3	not classifiable	not classifiable
ortho-Aminoazotoluene	2B	possibly carcinogenic	possibly carcinogenic
2,4-Diaminoanisole	2B	possibly carcinogenic	possibly carcinogenic
4-Chloronitrobenzene	2B	possibly carcinogenic	not classifiable
N'-Nitrosoanabasine (NAB)	3	not classifiable	probably carcinogenic
Fluorides (inorganic, used in drinking-water)	3	not classifiable	not classifiable
Benz[j]aceanthrylene	2B	possibly carcinogenic	not classifiable
Carmoisine	3	not classifiable	not classifiable
Benzo[j]fluoranthene	2B	possibly carcinogenic	probably carcinogenic
Dibenz[a,j]acridine	2A	probably carcinogenic	possibly carcinogenic
Butyl methacrylate	2B	possibly carcinogenic	not classifiable
6-Methylchrysene	3	not classifiable	possibly carcinogenic
Benzo[b]fluoranthene	2B	possibly carcinogenic	possibly carcinogenic
N,N'-Diacetylbenzidine	2B	possibly carcinogenic	not classifiable
ortho-Phenylenediamine dihydrochloride	2B	possibly carcinogenic	possibly carcinogenic
para-Nitroanisole	2B	possibly carcinogenic	not classifiable
Adriamycin (Doxorubicin)	2A	probably carcinogenic	probably carcinogenic
4-Chlorobenzotrifluoride	2B	possibly carcinogenic	not classifiable
Isophosphamide	3	not classifiable	not classifiable
Captafol	2A	probably carcinogenic	possibly carcinogenic
Cyclopenta[cd]pyrene	2A	probably carcinogenic	carcinogenic to humans
3-Methylfluoranthene	3	not classifiable	not classifiable
Digoxin	2B	possibly carcinogenic	not classifiable
Ethylbenzene	2B	possibly carcinogenic	possibly carcinogenic
Coronene	3	not classifiable	not classifiable
N-Methyl-N-nitrosourethane	2B	possibly carcinogenic	carcinogenic to humans
Furfuryl alcohol	2B	possibly carcinogenic	possibly carcinogenic
4-Vinylcyclohexene	2B	possibly carcinogenic	possibly carcinogenic
Benzo[k]fluoranthene	2B	possibly carcinogenic	possibly carcinogenic
Cumene	2B	possibly carcinogenic	possibly carcinogenic
Ethyl methanesulfonate	2B	possibly carcinogenic	not classifiable
Brilliant Blue FCF, disodium salt	3	not classifiable	not classifiable
Benzo[ghi]perylene	3	not classifiable	not classifiable
1,2,3-Tris(chloromethoxy)propane	3	not classifiable	carcinogenic to humans
Acrylic acid	3	not classifiable	not classifiable
Daunomycin (Daunorubicin)	2B	possibly carcinogenic	probably carcinogenic
N-Nitrosopiperidine	2B	possibly carcinogenic	probably carcinogenic
Dichlorvos	2B	possibly carcinogenic	possibly carcinogenic
Nitrobenzene	2B	possibly carcinogenic	possibly carcinogenic
α-Methylstyrene	2B	possibly carcinogenic	not classifiable
Teniposide	2A	probably carcinogenic	carcinogenic to humans
Hydrazine	2A	probably carcinogenic	possibly carcinogenic
Anthanthrene	3	not classifiable	not classifiable
Chrysene	2B	possibly carcinogenic	possibly carcinogenic
Thioacetamide	2B	possibly carcinogenic	possibly carcinogenic
Atrazine	3	not classifiable	not classifiable
4,5',8-Trimethylpsoralen	3	not classifiable	carcinogenic to humans
Sterigmatocystin	2B	possibly carcinogenic	possibly carcinogenic
Chloral hydrate	2A	probably carcinogenic	not classifiable
Michler’s base [4,4´-methylenebis(N,N-dimethyl)­benzenamine]	2B	possibly carcinogenic	probably carcinogenic
4,5'-Dimethylangelicin plus ultraviolet A radiation	3	not classifiable	probably carcinogenic
Tetrachlorvinphos	2B	possibly carcinogenic	possibly carcinogenic
Azacitidine	2A	probably carcinogenic	possibly carcinogenic
N-Nitrosodi-n-propylamine	2B	possibly carcinogenic	possibly carcinogenic
Diazinon	2A	probably carcinogenic	probably carcinogenic
Picloram	3	not classifiable	not classifiable
4,4'-Methylenedianiline	2B	possibly carcinogenic	probably carcinogenic
N,N-Dimethyl-p-toluidine	2B	possibly carcinogenic	not classifiable
Dibenz[c,h]acridine	2B	possibly carcinogenic	possibly carcinogenic
Doxefazepam	3	not classifiable	not classifiable
Ethylene sulfide	3	not classifiable	not classifiable
Dibenzo[h,rst]pentaphene	3	not classifiable	carcinogenic to humans
3,9-Dinitrofluoranthene	2B	possibly carcinogenic	possibly carcinogenic
Trp-P-1 (3-Amino-1,4-dimethyl-5H-pyrido[4,3-b]indole)	2B	possibly carcinogenic	possibly carcinogenic
4,4'-Diaminodiphenyl ether	2B	possibly carcinogenic	not classifiable
Fusarium graminearum, F. culmorum, and F. crookwellense, toxins derived from (zearalenone, deoxynivalenol, nivalenol, and fusarenone X)	3	not classifiable	not classifiable
Fusarium sporotrichioides, toxins derived from (T-2 toxin)	3	not classifiable	possibly carcinogenic
Dibenzo[e,l]pyrene	3	not classifiable	carcinogenic to humans
Trp-P-2 (3-Amino-1-methyl-5H-pyrido[4,3-b]indole)	2B	possibly carcinogenic	possibly carcinogenic
Diazepam	3	not classifiable	not classifiable
Dibenz[a,h]acridine	2B	possibly carcinogenic	probably carcinogenic
Microcystis extracts	3	not classifiable	possibly carcinogenic
Diglycidyl resorcinol ether	2B	possibly carcinogenic	probably carcinogenic
Phenoxybenzamine hydrochloride	2B	possibly carcinogenic	possibly carcinogenic
Procarbazine hydrochloride	2A	probably carcinogenic	carcinogenic to humans
Ponceau SX	3	not classifiable	not classifiable
Microcystin-LR	2B	possibly carcinogenic	possibly carcinogenic
Dibenzo[a,e]pyrene	3	not classifiable	carcinogenic to humans
Silicon carbide whiskers	2A	probably carcinogenic	probably carcinogenic
Dihydroxymethylfuratrizine (see also Panfuran S)	3	not classifiable	carcinogenic to humans
Aspartame	2B	possibly carcinogenic	possibly carcinogenic
2-Ethylhexyl acrylate	2B	possibly carcinogenic	not classifiable
5-Aminoacenaphthene	3	not classifiable	not classifiable
1,1,1,2-Tetrachloroethane	2B	possibly carcinogenic	not classifiable
Opisthorchis felineus (infection with)	3	not classifiable	carcinogenic to humans
Benzo[e]pyrene	3	not classifiable	not classifiable
5-Methoxypsoralen	2A	probably carcinogenic	probably carcinogenic
Human papillomavirus (HPV) genus beta (except types 5 and 8) and genus gamma	3	not classifiable	not classifiable
Perfluorooctanoic acid (PFOA)	1	carcinogenic to humans	carcinogenic to humans
ortho-Phenylphenol	3	not classifiable	possibly carcinogenic
Aurothioglucose	3	not classifiable	not classifiable
Insulation glass wool	3	not classifiable	not classifiable
Methyl methacrylate	3	not classifiable	not classifiable
Hexamethylphosphoramide	2B	possibly carcinogenic	probably carcinogenic
Polyvinyl alcohol	3	not classifiable	not classifiable
Vinylidene chloride-vinyl chloride copolymers	3	not classifiable	not classifiable
Magenta	2B	possibly carcinogenic	not classifiable
5-(Morpholinomethyl)-3-[(5-nitrofurfurylidene)­amino]-2-oxazolidinone	2B	possibly carcinogenic	not classifiable
Ethionamide	3	not classifiable	not classifiable
Human T-cell lymphotropic virus type II	3	not classifiable	not classifiable
Leather tanning and processing	3	not classifiable	carcinogenic to humans
2-(1-Aziridinyl)ethanol	3	not classifiable	not classifiable
Chlorinated drinking-water	3	not classifiable	not classifiable
Apholate	3	not classifiable	not classifiable
N'-Nitrosoanatabine (NAT)	3	not classifiable	not classifiable
Polymethylene polyphenyl isocyanate	3	not classifiable	not classifiable
Pentosan polysulfate sodium	2B	possibly carcinogenic	not classifiable
Vinyl chloride-vinyl acetate copolymers	3	not classifiable	not classifiable
Allyl chloride	3	not classifiable	possibly carcinogenic
Furosemide (Frusemide)	3	not classifiable	not classifiable
Yellow OB	3	not classifiable	probably carcinogenic
HC Blue No. 1	2B	possibly carcinogenic	not classifiable
Acrylamide	2A	probably carcinogenic	probably carcinogenic
Radium-224 and its decay products	1	carcinogenic to humans	carcinogenic to humans
6-Nitrochrysene	2A	probably carcinogenic	probably carcinogenic
1,4-Diamino-2-nitrobenzene	3	not classifiable	not classifiable
Hycanthone mesylate	3	not classifiable	possibly carcinogenic
Bis(chloromethyl)ether; chloromethyl methyl ether (technical-grade)	1	carcinogenic to humans	carcinogenic to humans
Acetaldehyde	2B	possibly carcinogenic	possibly carcinogenic
Pronetalol hydrochloride	3	not classifiable	not classifiable
Coal dust	3	not classifiable	not classifiable
Polytetrafluoroethylene	3	not classifiable	not classifiable
Diphenylamine	2B	possibly carcinogenic	PARSE_FAIL
Coal-tar distillation	1	carcinogenic to humans	carcinogenic to humans
AF-2 [2-(2-Furyl)-3-(5-nitro-2-furyl)acrylamide]	2B	possibly carcinogenic	carcinogenic to humans
Arsenic and inorganic arsenic compounds	1	carcinogenic to humans	carcinogenic to humans
Cobalt metal (without tungsten carbide or other metal alloys)	2A	probably carcinogenic	possibly carcinogenic
1,2-Dimethylhydrazine	2A	probably carcinogenic	possibly carcinogenic
Ochratoxin A	2B	possibly carcinogenic	possibly carcinogenic
Jacobine	3	not classifiable	possibly carcinogenic
Polyvinyl chloride	3	not classifiable	not classifiable
5,6-Cyclopenteno-1,2-benzanthracene	3	not classifiable	probably carcinogenic
para-Phenylenediamine	3	not classifiable	not classifiable
N-Vinyl-2-pyrrolidone	3	not classifiable	not classifiable
Propham	3	not classifiable	not classifiable
Endrin	3	not classifiable	not classifiable
Beryllium and beryllium compounds	1	carcinogenic to humans	carcinogenic to humans
Bleomycins	2B	possibly carcinogenic	probably carcinogenic
2-Amino-5-nitrothiazole	3	not classifiable	not classifiable
para-Cresidine	2B	possibly carcinogenic	possibly carcinogenic
Vat Yellow 4	3	not classifiable	not classifiable
Penicillic acid	3	not classifiable	not classifiable
Implanted foreign bodies of metallic chromium or titanium and of cobalt-based, chromium-based, and titanium-based alloys, and stainless steel	3	not classifiable	not classifiable
Methyl isobutyl ketone	2B	possibly carcinogenic	not classifiable
Dapsone	3	not classifiable	not classifiable
Naphtho[1,2-b]fluoranthene	3	not classifiable	carcinogenic to humans
Busulfan	1	carcinogenic to humans	carcinogenic to humans
Zalcitabine	2B	possibly carcinogenic	not classifiable
1,2-Dichloropropane	1	carcinogenic to humans	possibly carcinogenic
N'-Nitrosonornicotine (NNN) and 4-(N-Nitrosomethylamino)-1-(3-pyridyl)-1-butanone (NNK)	1	carcinogenic to humans	carcinogenic to humans
Glu-P-1 (2-Amino-6-methyldipyrido[1,2-a:3',2'-d]imidazole)	2B	possibly carcinogenic	possibly carcinogenic
6-Nitrobenzo[a]pyrene	3	not classifiable	possibly carcinogenic
Maneb	3	not classifiable	not classifiable
Naphtho[2,3-e]pyrene	3	not classifiable	not classifiable
N-Nitrosodiethylamine	2A	probably carcinogenic	probably carcinogenic
Polyvinyl pyrrolidone	3	not classifiable	not classifiable
Ethyl tert-butyl ether	2B	possibly carcinogenic	not classifiable
Phenacetin	1	carcinogenic to humans	carcinogenic to humans
Butylated hydroxyanisole (BHA)	2B	possibly carcinogenic	possibly carcinogenic
Ethanol in alcoholic beverages	1	carcinogenic to humans	carcinogenic to humans
Perylene	3	not classifiable	not classifiable
Fusarium moniliforme, toxins derived from (fumonisin B1, fumonisin B2, and fusarin C)	2B	possibly carcinogenic	possibly carcinogenic
Chloroquine	3	not classifiable	not classifiable
Didanosine	3	not classifiable	not classifiable
Oestradiol mustard	3	not classifiable	not classifiable
Piperonyl butoxide	3	not classifiable	not classifiable
2-(2-Formylhydrazino)-4-(5-nitro-2-furyl)thiazole	2B	possibly carcinogenic	carcinogenic to humans
CI Acid Orange 20	3	not classifiable	not classifiable
Bisulfites	3	not classifiable	not classifiable
Hypochlorite salts	3	not classifiable	not classifiable
PhIP (2-Amino-1-methyl-6-phenylimidazo[4,5-b]pyridine)	2B	possibly carcinogenic	possibly carcinogenic
N,N-Dimethylformamide	2A	probably carcinogenic	possibly carcinogenic
trans-2-[(Dimethylamino)methylimino]-5-[2-(5-nitro-2-furyl)-vinyl]-1,3,4-oxadiazole	2B	possibly carcinogenic	not classifiable
1,2-Diphenylhydrazine	2B	possibly carcinogenic	not classifiable
Methylene blue	3	not classifiable	not classifiable
Aniline (see also Aniline hydrochloride)	2A	probably carcinogenic	not classifiable
Phenylbutazone	3	not classifiable	possibly carcinogenic
Glycidaldehyde	2B	possibly carcinogenic	possibly carcinogenic
Human papillomavirus (HPV) types 6 and 11	3	not classifiable	not classifiable
Hydrochlorothiazide	1	carcinogenic to humans	possibly carcinogenic
Hydroxyurea	3	not classifiable	not classifiable
Caffeic acid	2B	possibly carcinogenic	not classifiable
Benzophenone	2B	possibly carcinogenic	possibly carcinogenic
N-Nitrosomethylethylamine	2B	possibly carcinogenic	possibly carcinogenic
Uracil mustard	2B	possibly carcinogenic	carcinogenic to humans
Fluoranthene	3	not classifiable	not classifiable
Tris(aziridinyl)-para-benzoquinone (Triaziquone)	3	not classifiable	probably carcinogenic
Diethyl sulfate	2A	probably carcinogenic	carcinogenic to humans
Methyl methanesulfonate	2A	probably carcinogenic	not classifiable
Tetrahydrofuran	2B	possibly carcinogenic	not classifiable
1-Bromopropane	2B	possibly carcinogenic	probably carcinogenic
Reserpine	3	not classifiable	possibly carcinogenic
1,3-Dinitropyrene	2B	possibly carcinogenic	possibly carcinogenic
N-Ethyl-N-nitrosourea	2A	probably carcinogenic	probably carcinogenic
Phosphorus-32, as phosphate	1	carcinogenic to humans	carcinogenic to humans
Diethylstilbestrol	1	carcinogenic to humans	carcinogenic to humans
Chlordimeform	3	not classifiable	not classifiable
Vinyl fluoride	2A	probably carcinogenic	not classifiable
Palygorskite (Attapulgite)(short fibres, < 5 micrometres)	3	not classifiable	probably carcinogenic
Dibenz[a,h]anthracene	2A	probably carcinogenic	carcinogenic to humans
Vinyl chloride	1	carcinogenic to humans	carcinogenic to humans
Rosiglitazone	3	not classifiable	not classifiable
1,2-Dihydroaceanthrylene	3	not classifiable	not classifiable
Polybrominated biphenyls	2A	probably carcinogenic	possibly carcinogenic
Bitumens, occupational exposure to oxidized bitumens and their emissions during roofing	2A	probably carcinogenic	probably carcinogenic
Radium-228 and its decay products	1	carcinogenic to humans	carcinogenic to humans
Polypropylene	3	not classifiable	not classifiable
Hexachlorophene	3	not classifiable	not classifiable
Vitamin K substances	3	not classifiable	not classifiable
Isopropyl alcohol	3	not classifiable	not classifiable
Creosotes	2A	probably carcinogenic	probably carcinogenic
Di(2-ethylhexyl)phthalate	2B	possibly carcinogenic	possibly carcinogenic
trans-1,4-Dichlorobutene	3	not classifiable	not classifiable
Dimethylarsinic acid	2B	possibly carcinogenic	possibly carcinogenic
7-Nitrobenz[a]anthracene	3	not classifiable	probably carcinogenic
Monocrotaline	2B	possibly carcinogenic	not classifiable
Benzo[g]chrysene	3	not classifiable	not classifiable
CI Direct Blue 218	2B	possibly carcinogenic	not classifiable
Butylated hydroxytoluene (BHT)	3	not classifiable	not classifiable
Trypan blue	2B	possibly carcinogenic	possibly carcinogenic
Dimethylcarbamoyl chloride	2A	probably carcinogenic	carcinogenic to humans
Toluene	3	not classifiable	not classifiable
Benzofuran	2B	possibly carcinogenic	possibly carcinogenic
Mitoxantrone	2B	possibly carcinogenic	probably carcinogenic
Kojic acid	3	not classifiable	not classifiable
2-Bromopropane	2A	probably carcinogenic	carcinogenic to humans
Dieldrin, and aldrin metabolized to dieldrin	2A	probably carcinogenic	possibly carcinogenic
Actinomycin D	3	not classifiable	possibly carcinogenic
Bis(2-chloroethyl)ether	3	not classifiable	possibly carcinogenic
Polyvinyl acetate	3	not classifiable	not classifiable
Thiourea	3	not classifiable	possibly carcinogenic
Sulfafurazole (Sulfisoxazole)	3	not classifiable	not classifiable
2,3,7,8-Tetrachlorodibenzo-para-dioxin	1	carcinogenic to humans	carcinogenic to humans
1-Naphthylthiourea (ANTU)	3	not classifiable	not classifiable
1,6-Dinitropyrene	2B	possibly carcinogenic	probably carcinogenic
Silicon carbide, fibrous	2B	possibly carcinogenic	probably carcinogenic
para-Chloroaniline	2B	possibly carcinogenic	not classifiable
Trichloroacetic acid	2B	possibly carcinogenic	possibly carcinogenic
Diethanolamine	2B	possibly carcinogenic	possibly carcinogenic
Triamterene	2B	possibly carcinogenic	not classifiable
Citrus Red No. 2	2B	possibly carcinogenic	possibly carcinogenic
Acrylonitrile-butadiene-styrene copolymers	3	not classifiable	not classifiable
2,2-Bis(bromomethyl)propane-1,3-diol	2B	possibly carcinogenic	probably carcinogenic
Trichloroethylene	1	carcinogenic to humans	carcinogenic to humans
6-Mercaptopurine	3	not classifiable	carcinogenic to humans
Toluene diisocyanates	2B	possibly carcinogenic	possibly carcinogenic
Chromium (VI) compounds	1	carcinogenic to humans	carcinogenic to humans
Polyacrylic acid	3	not classifiable	PARSE_FAIL
Pyridine	2B	possibly carcinogenic	not classifiable
Plutonium	1	carcinogenic to humans	carcinogenic to humans
Simazine	3	not classifiable	possibly carcinogenic
Tacrolimus	1	carcinogenic to humans	probably carcinogenic
Dicofol	3	not classifiable	not classifiable
Jet fuel	3	not classifiable	not classifiable
5-Fluorouracil	3	not classifiable	not classifiable
2,4,6-Trinitrotoluene	3	not classifiable	not classifiable
Treosulfan	1	carcinogenic to humans	carcinogenic to humans
Coal-tar pitch	1	carcinogenic to humans	carcinogenic to humans
Ceramic implants	3	not classifiable	not classifiable
Polychloroprene	3	not classifiable	not classifiable
2-Nitrotoluene	2A	probably carcinogenic	possibly carcinogenic
1-Nitropyrene	2A	probably carcinogenic	probably carcinogenic
1-Nitronaphthalene	3	not classifiable	not classifiable
2-Butoxyethanol	3	not classifiable	not classifiable
Sudan Brown RR	3	not classifiable	not classifiable
Isopropyl oils	3	not classifiable	carcinogenic to humans
Hexachlorobutadiene	3	not classifiable	probably carcinogenic
Aflatoxins	1	carcinogenic to humans	carcinogenic to humans
Etoposide	1	carcinogenic to humans	carcinogenic to humans
Nafenopin	2B	possibly carcinogenic	not classifiable
Asbestos (all forms, including actinolite, amosite, anthophyllite, chrysotile, crocidolite, tremolite)	1	carcinogenic to humans	carcinogenic to humans
N-Nitrosodiethanolamine	2B	possibly carcinogenic	possibly carcinogenic
Amitrole	3	not classifiable	not classifiable
Cadmium and cadmium compounds	1	carcinogenic to humans	carcinogenic to humans
Potassium bromate	2B	possibly carcinogenic	possibly carcinogenic
Chlorodibromomethane	3	not classifiable	possibly carcinogenic
Furazolidone	3	not classifiable	possibly carcinogenic
3-Nitrofluoranthene	3	not classifiable	possibly carcinogenic
Calcium carbide production	3	not classifiable	not classifiable
Heptachlor	2B	possibly carcinogenic	possibly carcinogenic
Radon-222 and its decay products	1	carcinogenic to humans	carcinogenic to humans
Madder root (Rubia tinctorum)	3	not classifiable	possibly carcinogenic
Furan	2B	possibly carcinogenic	possibly carcinogenic
Prednisone	3	not classifiable	not classifiable
Aristolochic acid	1	carcinogenic to humans	carcinogenic to humans
4-Chloro-meta-phenylenediamine	3	not classifiable	possibly carcinogenic
DDT (4,4'-dichlorodiphenyltrichloroethane)	2A	probably carcinogenic	probably carcinogenic
5-Methylchrysene	2B	possibly carcinogenic	carcinogenic to humans
Uranium, mixture of isotopes (see Radionuclides, alpha-particle-emitting, internally deposited)	1	carcinogenic to humans	carcinogenic to humans
Mineral oils, highly-refined	3	not classifiable	not classifiable
Cyclophosphamide	1	carcinogenic to humans	carcinogenic to humans
Dibenzo[a,e]fluoranthene	3	not classifiable	probably carcinogenic
Nodularins	3	not classifiable	probably carcinogenic
Hydroquinone	3	not classifiable	not classifiable
Ciclosporin	1	carcinogenic to humans	carcinogenic to humans
Polymethyl methacrylate	3	not classifiable	not classifiable
Ptaquiloside	3	not classifiable	possibly carcinogenic
Deltamethrin	3	not classifiable	not classifiable
Vinyl acetate	2B	possibly carcinogenic	not classifiable
1-(2-Chloroethyl)-3-(4-methylcyclohexyl)-1-nitrosourea (Methyl-CCNU) (Semustine)	1	carcinogenic to humans	carcinogenic to humans
Dimethyl sulfate	2A	probably carcinogenic	carcinogenic to humans
Catechol	2B	possibly carcinogenic	not classifiable
2,6-Dichloro-para-phenylenediamine	3	not classifiable	not classifiable
Succinic anhydride	3	not classifiable	not classifiable
3,5-Dinitrotoluene	3	not classifiable	not classifiable
Seneciphylline	3	not classifiable	possibly carcinogenic
2-Amino-5-(5-nitro-2-furyl)-1,3,4-thiadiazole	2B	possibly carcinogenic	possibly carcinogenic
Melphalan	1	carcinogenic to humans	carcinogenic to humans
Tris(2-chloroethyl) phosphate	3	not classifiable	possibly carcinogenic
Leucogentian violet (see also Gentian violet)	3	not classifiable	not classifiable
Citrinin	3	not classifiable	not classifiable
Maleic hydrazide	3	not classifiable	not classifiable
Ampicillin	3	not classifiable	not classifiable
3-Chloronitrobenzene	3	not classifiable	not classifiable
Dibenz[a,j]anthracene	3	not classifiable	probably carcinogenic
4,4'-Dimethylangelicin plus ultraviolet A radiation	3	not classifiable	not classifiable
Etoposide in combination with cisplatin and bleomycin	1	carcinogenic to humans	carcinogenic to humans
N-Nitrosodimethylamine	2A	probably carcinogenic	probably carcinogenic
3,3’,4,4’,5-Pentachlorobiphenyl (PCB-126)	1	carcinogenic to humans	carcinogenic to humans
Oxyphenbutazone	3	not classifiable	not classifiable
9-Nitroanthracene	3	not classifiable	not classifiable
Methoxychlor	3	not classifiable	possibly carcinogenic
Anaesthetics, volatile	3	not classifiable	not classifiable
Diallate	3	not classifiable	not classifiable
Radium-226 and its decay products	1	carcinogenic to humans	carcinogenic to humans
2-Amino-5-nitrophenol	3	not classifiable	not classifiable
Lead compounds, organic	3	not classifiable	not classifiable
Vinyl bromide	2A	probably carcinogenic	probably carcinogenic
Disperse Blue 1	2B	possibly carcinogenic	possibly carcinogenic
Metabisulfites	3	not classifiable	not classifiable
Dental materials	3	not classifiable	not classifiable
Diesel fuels, distillate (light)	3	not classifiable	carcinogenic to humans
Tetrabromobisphenol A	2A	probably carcinogenic	not classifiable
N,N-Dimethylaniline	3	not classifiable	not classifiable
Decabromodiphenyl oxide	3	not classifiable	not classifiable
Trichlorfon	3	not classifiable	not classifiable
Fluorescent lighting	3	not classifiable	not classifiable
Polystyrene	3	not classifiable	not classifiable
CI Orange G	3	not classifiable	not classifiable
Anthracene	2B	possibly carcinogenic	not classifiable
Nickel, metallic	2B	possibly carcinogenic	possibly carcinogenic
Glycidol	2A	probably carcinogenic	probably carcinogenic
IQ (2-Amino-3-methylimidazo[4,5-f]quinoline)	2A	probably carcinogenic	possibly carcinogenic
Coconut oil diethanolamine condensate	2B	possibly carcinogenic	possibly carcinogenic
Organic polymeric materials	3	not classifiable	not classifiable
Sulfamethoxazole	3	not classifiable	not classifiable
Clofibrate	3	not classifiable	possibly carcinogenic
Propylene	3	not classifiable	not classifiable
n-Propyl carbamate	3	not classifiable	not classifiable
Oil Orange SS	2B	possibly carcinogenic	possibly carcinogenic
Formaldehyde	1	carcinogenic to humans	carcinogenic to humans
Dibromoacetic acid	2B	possibly carcinogenic	possibly carcinogenic
Sulfur mustard	1	carcinogenic to humans	carcinogenic to humans
Chrysoidine	3	not classifiable	possibly carcinogenic
Dibromoacetonitrile	2B	possibly carcinogenic	not classifiable
3,3'-Dichloro-4,4'-diaminodiphenyl ether	2B	possibly carcinogenic	possibly carcinogenic
1,4-Dimethylphenanthrene	3	not classifiable	not classifiable
Fluorene	3	not classifiable	not classifiable
Lumber and sawmill industries (including logging)	3	not classifiable	carcinogenic to humans
Modacrylic fibres	3	not classifiable	not classifiable
Nitrofurantoin	3	not classifiable	not classifiable
Benz[c]acridine	3	not classifiable	possibly carcinogenic
Phenyl glycidyl ether	2B	possibly carcinogenic	possibly carcinogenic
Coffee, drinking	3	not classifiable	possibly carcinogenic
3,3'-Dimethylbenzidine (ortho-Tolidine)	2B	possibly carcinogenic	possibly carcinogenic
Carrageenan, native	3	not classifiable	not classifiable
2,4,6-Trimethylaniline	3	not classifiable	possibly carcinogenic
Hair colouring products (personal use of)	3	not classifiable	not classifiable
Dacarbazine	2B	possibly carcinogenic	carcinogenic to humans
Senkirkine	3	not classifiable	not classifiable
Dichloromethane (Methylene chloride)	2A	probably carcinogenic	probably carcinogenic
Phenolphthalein	2B	possibly carcinogenic	possibly carcinogenic
Clonorchis sinensis (infection with)	1	carcinogenic to humans	carcinogenic to humans
Cobalt metal with tungsten carbide	2A	probably carcinogenic	probably carcinogenic
Palygorskite (Attapulgite) (long fibres, > 5 micrometres)	2B	possibly carcinogenic	possibly carcinogenic
4-Vinylcyclohexene diepoxide	2B	possibly carcinogenic	not classifiable
Nitromethane	2B	possibly carcinogenic	possibly carcinogenic
Aristolochic acid, plants containing	1	carcinogenic to humans	carcinogenic to humans
Spironolactone	3	not classifiable	possibly carcinogenic
2,4-Dinitrotoluene	2B	possibly carcinogenic	possibly carcinogenic
Benzene	1	carcinogenic to humans	carcinogenic to humans
Schistosoma mansoni (infection with)	3	not classifiable	not classifiable
Chlorendic acid	2B	possibly carcinogenic	possibly carcinogenic
1,8-Dinitropyrene	2B	possibly carcinogenic	probably carcinogenic
MeA-alpha-C (2-Amino-3-methyl-9H-pyrido[2,3-b]indole)	2B	possibly carcinogenic	possibly carcinogenic
Voriconazole	1	carcinogenic to humans	probably carcinogenic
4,4'-Methylenebis(2-chloroaniline) (MOCA)	1	carcinogenic to humans	carcinogenic to humans
Electric fields, extremely low-frequency	3	not classifiable	possibly carcinogenic
Polychlorinated biphenyls	1	carcinogenic to humans	carcinogenic to humans
Styrene-butadiene copolymers	3	not classifiable	not classifiable
Guinea Green B	3	not classifiable	not classifiable
Propylene oxide	2B	possibly carcinogenic	possibly carcinogenic
Azathioprine	1	carcinogenic to humans	carcinogenic to humans
1,3-Butadiene	1	carcinogenic to humans	carcinogenic to humans
Leather goods manufacture (see also Leather dust)	3	not classifiable	carcinogenic to humans
Permethrin	3	not classifiable	possibly carcinogenic
Vinylidene chloride	2B	possibly carcinogenic	not classifiable
CI Acid Orange 3	3	not classifiable	not classifiable
para-Dichlorobenzene	2B	possibly carcinogenic	possibly carcinogenic
β-Picoline	3	not classifiable	not classifiable
Isosafrole	3	not classifiable	possibly carcinogenic
Lasiocarpine	2B	possibly carcinogenic	possibly carcinogenic
Glu-P-2 (2-Aminodipyrido[1,2-a:3',2'-d]imidazole)	2B	possibly carcinogenic	possibly carcinogenic
Iron-dextrin complex	3	not classifiable	not classifiable
Benzo[ghi]fluoranthene	3	not classifiable	not classifiable
Lead	2B	possibly carcinogenic	probably carcinogenic
Fenvalerate	3	not classifiable	not classifiable
3,3'-Dimethoxybenzidine (ortho-Dianisidine)	2B	possibly carcinogenic	possibly carcinogenic
Zineb	3	not classifiable	not classifiable
Chloral	2A	probably carcinogenic	possibly carcinogenic
1,1,1-Trichloroethane	2A	probably carcinogenic	not classifiable
Hexachlorobenzene	2B	possibly carcinogenic	possibly carcinogenic
Lauroyl peroxide	3	not classifiable	not classifiable
Chloroform	2B	possibly carcinogenic	possibly carcinogenic
Medphalan	3	not classifiable	carcinogenic to humans
2-Methylimidazole	2B	possibly carcinogenic	possibly carcinogenic
Carbon nanotubes, multiwalled MWCNT-7	2B	possibly carcinogenic	possibly carcinogenic
Chlorobenzilate	3	not classifiable	not classifiable
Ethyl carbamate (Urethane)	2A	probably carcinogenic	probably carcinogenic
Erionite	1	carcinogenic to humans	carcinogenic to humans
Cimetidine	3	not classifiable	not classifiable
X- and Gamma-Radiation	1	carcinogenic to humans	carcinogenic to humans
Acetaldehyde associated with consumption of alcoholic beverages	1	carcinogenic to humans	carcinogenic to humans
Magnetic fields, static	3	not classifiable	not classifiable
Acrylonitrile	1	carcinogenic to humans	possibly carcinogenic
Fuel oils, distillate (light)	3	not classifiable	carcinogenic to humans
Bromodichloromethane	2B	possibly carcinogenic	possibly carcinogenic
Diisopropyl sulfate	2B	possibly carcinogenic	probably carcinogenic
Lindane (see also Hexachlorocyclohexanes)	1	carcinogenic to humans	carcinogenic to humans
Naphtho[2,1-a]fluoranthene	3	not classifiable	not classifiable
Pyrene	3	not classifiable	not classifiable
Toremifene	3	not classifiable	possibly carcinogenic
Chloramphenicol	2A	probably carcinogenic	possibly carcinogenic
Chlornaphazine	1	carcinogenic to humans	carcinogenic to humans
D & C Red No. 9	3	not classifiable	not classifiable
Ferric oxide	3	not classifiable	not classifiable
Morpholine	3	not classifiable	not classifiable
Sudan Red 7B	3	not classifiable	not classifiable
Petasitenine	3	not classifiable	possibly carcinogenic
Thorium-232 and its decay products	1	carcinogenic to humans	carcinogenic to humans
Fumonisin B1	2B	possibly carcinogenic	possibly carcinogenic
Arsenobetaine and other organic arsenic compounds that are not metabolized in humans	3	not classifiable	not classifiable
Mirex	2B	possibly carcinogenic	possibly carcinogenic
CI Direct Blue 15	2B	possibly carcinogenic	probably carcinogenic
Ethylene oxide	1	carcinogenic to humans	carcinogenic to humans
Zidovudine (AZT)	2B	possibly carcinogenic	possibly carcinogenic
Carbaryl	3	not classifiable	probably carcinogenic
Glass filament, continuous	3	not classifiable	not classifiable
1,2-Dichloroethane	2B	possibly carcinogenic	possibly carcinogenic
Angelicin plus ultraviolet A radiation	3	not classifiable	possibly carcinogenic
Clomiphene citrate	3	not classifiable	possibly carcinogenic
Symphytine	3	not classifiable	possibly carcinogenic
2-Methylaziridine (Propyleneimine)	2B	possibly carcinogenic	possibly carcinogenic
Nitrogen mustard	2A	probably carcinogenic	carcinogenic to humans
Ponceau MX	2B	possibly carcinogenic	not classifiable
Benzo[a]fluoranthene	3	not classifiable	not classifiable
Electric fields, static	3	not classifiable	not classifiable
3-Nitroperylene	3	not classifiable	not classifiable
Styrene-acrylonitrile copolymers	3	not classifiable	not classifiable
3,7-Dinitrofluoranthene	2B	possibly carcinogenic	probably carcinogenic
N-Methyl-N-nitrosourea	2A	probably carcinogenic	probably carcinogenic
A-alpha-C (2-Amino-9H-pyrido[2,3-b]indole)	2B	possibly carcinogenic	possibly carcinogenic
Cyclochlorotine	3	not classifiable	not classifiable
Resorcinol	3	not classifiable	not classifiable
Aldicarb	3	not classifiable	not classifiable
Polyethylene	3	not classifiable	not classifiable
Retrorsine	3	not classifiable	possibly carcinogenic
Chloroacetonitrile	3	not classifiable	probably carcinogenic
Crotonaldehyde	2B	possibly carcinogenic	not classifiable
Medroxyprogesterone acetate	2B	possibly carcinogenic	probably carcinogenic
Cinnamyl anthranilate	3	not classifiable	possibly carcinogenic
Benzo[a]pyrene	1	carcinogenic to humans	carcinogenic to humans
Kaempferol	3	not classifiable	not classifiable
Cyclohexanone	3	not classifiable	not classifiable
2-Aminoanthraquinone	3	not classifiable	not classifiable
2,3,4,7,8-Pentachlorodibenzofuran	1	carcinogenic to humans	not classifiable
Fluometuron	3	not classifiable	not classifiable
Benzo[b]chrysene	3	not classifiable	carcinogenic to humans
Flat-glass and specialty glass (manufacture of)	3	not classifiable	carcinogenic to humans
Caprolactam	3	not classifiable	not classifiable
Triphenylene	3	not classifiable	not classifiable
beta-Butyrolactone	2B	possibly carcinogenic	possibly carcinogenic
CI Acid Red 114	2B	possibly carcinogenic	not classifiable
4H-Cyclopenta[def]chrysene	3	not classifiable	carcinogenic to humans
1,2-Epoxybutane	2B	possibly carcinogenic	possibly carcinogenic
3-Carbethoxypsoralen	3	not classifiable	not classifiable
3-Chloro-4-(dichloromethyl)-5-hydroxy-2(5H)-furanone	2B	possibly carcinogenic	possibly carcinogenic
Benzo[c]fluorene	3	not classifiable	probably carcinogenic
2,4'-Diphenyldiamine	3	not classifiable	not classifiable
Chloramine	3	not classifiable	PARSE_FAIL
Chlorambucil	1	carcinogenic to humans	carcinogenic to humans
T2-Trichothecene	3	not classifiable	not classifiable
Dithranol	3	not classifiable	not classifiable
Bis(2-chloro-1-methylethyl)ether	3	not classifiable	not classifiable
1,5-Naphthalenediamine	3	not classifiable	not classifiable
para-Quinone	3	not classifiable	not classifiable
N-Methyl-N´-nitro-N-nitrosoguanidine (MNNG)	2A	probably carcinogenic	carcinogenic to humans
Tamoxifen	1	carcinogenic to humans	carcinogenic to humans
Methoxsalen (8-methoxypsoralen) plus ultraviolet A radiation	1	carcinogenic to humans	carcinogenic to humans
Melamine	2B	possibly carcinogenic	possibly carcinogenic
Chlorozotocin	2A	probably carcinogenic	not classifiable
Acridine orange	3	not classifiable	not classifiable
Shale oils	1	carcinogenic to humans	carcinogenic to humans
Silica dust, crystalline, in the form of quartz or cristobalite	1	carcinogenic to humans	carcinogenic to humans
Cobalt(II,III) oxide	3	not classifiable	not classifiable
Thiotepa	1	carcinogenic to humans	carcinogenic to humans
Mate, not very hot (drinking)	3	not classifiable	not classifiable
1-Bromo-3-chloropropane	2B	possibly carcinogenic	not classifiable
11H-Benz[bc]aceanthrylene	3	not classifiable	not classifiable
Dantron (Chrysazin; 1,8-Dihydroxyanthraquinone)	2B	possibly carcinogenic	possibly carcinogenic
Benz[a]acridine	3	not classifiable	not classifiable
Picene	3	not classifiable	not classifiable
Azaserine	2B	possibly carcinogenic	possibly carcinogenic
Hexachloroethane	2B	possibly carcinogenic	possibly carcinogenic
Acrylic fibres	3	not classifiable	not classifiable
Polyurethane foams	3	not classifiable	PARSE_FAIL
Methyl red	3	not classifiable	not classifiable
Quercetin	3	not classifiable	not classifiable
Triethylene glycol diglycidyl ether	3	not classifiable	probably carcinogenic
Light Green SF	3	not classifiable	not classifiable
Bis(1-aziridinyl)morpholinophosphine sulfide	3	not classifiable	probably carcinogenic
Ethyl tellurac	3	not classifiable	not classifiable
13H-Dibenzo[a,g]fluorene	3	not classifiable	possibly carcinogenic
1-Butyl glycidyl ether	2B	possibly carcinogenic	not classifiable
Luteoskyrin	3	not classifiable	possibly carcinogenic
Vincristine sulfate	3	not classifiable	not classifiable
4-Amino-2-nitrophenol	3	not classifiable	not classifiable
Dibenz[a,c]anthracene	3	not classifiable	probably carcinogenic
Blue VRS	3	not classifiable	not classifiable
meta-Phenylenediamine	3	not classifiable	not classifiable
Anthranilic acid	3	not classifiable	not classifiable
MeIQx (2-Amino-3,8-dimethylimidazo[4,5-f]quinoxaline)	2B	possibly carcinogenic	possibly carcinogenic
Isophorone	2B	possibly carcinogenic	not classifiable
Ponceau 3R	2B	possibly carcinogenic	possibly carcinogenic
Diisopropyl ether	3	not classifiable	not classifiable
Phenol	3	not classifiable	not classifiable
Riddelliine	2B	possibly carcinogenic	probably carcinogenic
Benz[l]aceanthrylene	3	not classifiable	probably carcinogenic
MeIQ (2-Amino-3,4-dimethylimidazo[4,5-f]quinoline)	2B	possibly carcinogenic	possibly carcinogenic
